                   
   P   PP  PPP PPPP
      S            
     PPP   PP   PPP
 S                 
 P  P P   PP   PPPP
 R  A   R          
FFFFFFFFFFF   FFFFF